20,20,20,20,20,28,28,28,28,28
20,0,0,0,0,0,0,0,0,28
20,0,0,0,0,0,0,0,0,28
20,0,0,0,0,0,0,0,0,28
20,0,0,0,0,0,0,0,0,28
20,0,0,0,0,0,0,0,0,28
20,20,20,20,20,0,0,0,0,28
20,20,20,20,20,0,0,28,0,28
20,20,20,20,20,0,28,28,0,28
20,20,20,20,20,28,28,28,28,28
